2,2,1,2,6,4,1,2,6,4,4,4,4,4,4,1,
2,3,4,2,4,2,4,3,4,2,2,2,2,2,2,4,
2,2,4,3,4,2,4,2,4,2,3,2,2,3,2,4,
2,2,4,2,4,3,4,2,4,2,2,2,2,1,4,5,
6,4,4,4,4,4,4,4,7,2,2,2,2,4,2,2,
2,2,4,2,4,2,4,2,2,3,1,4,4,5,2,2,
2,2,4,2,4,2,1,4,4,4,5,2,2,2,2,2,
2,2,4,3,4,2,4,2,2,3,2,2,2,2,3,2,
2,2,4,2,4,2,6,4,4,4,4,4,4,4,4,4,
3,2,6,4,7,2,2,2,2,2,2,3,2,2,2,2,