2,2,2,1,4,4,4,5,2,2,2,1,4,4,4,5,
2,2,2,4,2,2,2,4,2,2,2,4,2,2,2,4,
2,3,2,4,2,3,2,4,2,3,2,4,2,3,2,4,
2,2,2,4,2,2,2,4,2,2,2,4,2,2,2,4,
6,4,4,4,4,4,4,7,2,6,4,4,4,4,4,7,
2,2,2,4,2,2,2,2,2,4,2,4,2,2,2,2,
2,2,2,4,2,3,2,2,2,4,2,4,2,3,2,2,
2,3,2,4,2,2,2,3,2,4,2,4,2,2,2,2,
2,2,2,4,2,2,2,2,2,4,2,6,4,4,4,4,
2,2,2,6,4,4,4,4,4,7,2,2,2,2,2,2,
