2,2,1,2,7,4,1,2,7,4,4,4,4,4,4,1,
2,3,4,2,4,2,4,3,4,2,2,2,2,2,2,4,
2,2,4,3,4,2,4,2,4,2,3,2,2,3,2,4,
2,2,4,2,4,3,4,2,4,2,2,2,2,1,4,5,
4,4,4,4,4,4,4,4,8,2,2,2,2,4,2,2,
2,2,4,2,4,2,4,2,3,2,1,4,4,5,2,2,
2,2,4,2,4,2,1,4,4,4,5,7,4,4,4,1,
2,2,4,3,4,2,4,2,2,3,2,4,2,3,2,4,
2,2,7,4,8,2,7,4,4,4,4,8,2,2,2,7,
2,2,2,2,2,2,2,2,2,2,2,2,2,2,2,2,