2,2,2,2,2,2,2,2,2,2,2,2,2,2,2,2,
2,2,7,4,4,4,1,2,7,4,4,4,4,4,4,4,
2,2,4,2,2,2,4,3,4,3,2,2,2,3,2,2,
2,2,4,2,3,2,4,2,4,2,2,3,2,2,2,2,
2,2,4,2,2,2,4,3,8,4,4,4,4,4,5,2,
2,2,4,2,3,2,4,2,2,2,2,2,2,2,4,2,
2,2,4,2,2,2,4,3,2,3,2,3,2,3,4,2,
2,2,4,2,2,2,4,2,2,2,2,2,2,2,4,2,
4,4,8,2,3,2,7,4,4,4,4,4,4,4,8,2,
2,2,2,2,2,2,2,2,2,2,2,2,2,2,2,2,